北海道 	札幌市
青森県 	青森市
岩手県 	盛岡市
宮城県 	仙台市
秋田県 	秋田市
山形県 	山形市
福島県 	福島市
茨城県 	水戸市
栃木県 	宇都宮市
群馬県 	前橋市
埼玉県 	さいたま市
千葉県 	千葉市
東京都 	特別行政区
神奈川県 	横浜市
山梨県 	甲府市
新潟県 	新潟市
長野県 	長野市
富山県 	富山市
石川県 	金沢市
福井県 	福井市
愛知県 	名古屋市
岐阜県 	岐阜市
静岡県 	静岡市
三重県 	津市
